+-+-+-+-+-+-+
| | |       |
+ + +-+ + + +
|   |   | | |
+-+ + + +-+-+
|     | | | |
+ + + +-+ + +
| | |     | |
+ +-+-+ + + +
| |     | | |
+ +-+ +-+ + +
|   |   |   |
+-+ + + + +-+
|   | | |   |
+ + + +-+-+ +
| | | | |   |
+-+-+ + + +-+
|       |   |
+-+-+-+-+-+-+
