+-+-+-+-+-+
| | |   | |
+ + + +-+ +
|   | |   |
+-+ + + + +
| |   | | |
+ + +-+-+ +
|     |   |
+ +-+ + + +
|   |   | |
+-+-+-+-+-+