+-+-+-+-+-+-+-+-+-+-+-+-+-+-+-+
|         | |   |       | |   |
+ +-+ + + + +-+ + +-+-+-+ + +-+
| | | | | | |       | |     | |
+ + +-+ +-+ + + +-+ + + + + + +
|     | | | | |   |     | | | |
+-+ +-+-+ + +-+ +-+-+-+-+-+ + +
| | |         |   |   |       |
+ + + + + + + + +-+-+ + +-+-+-+
| |   | | | | |   | | | | | | |
+ + + +-+ +-+ + +-+ + +-+ + + +
|   | |   |   |     | |   | | |
+ + +-+ + + +-+-+-+ + + + + + +
| |   | | |   | |       |     |
+ +-+ + + + +-+ + +-+ + + + +-+
|   | | | | |       | | | |   |
+ + + +-+ +-+ + + +-+ + +-+ + +
| | | |     | | |   | | |   | |
+-+ + + +-+-+-+-+ +-+-+ + +-+-+
|   | |       | | | | | | |   |
+ + + +-+ +-+-+ + + + +-+-+-+ +
| | | |   | | | |   |     | | |
+-+ +-+ +-+ + + + +-+-+-+ + + +
|     |     | |     |       | |
+ +-+ + + + + + + +-+-+ + + + +
|   | | | | | | | |     | | | |
+-+-+ +-+ +-+ +-+ + + +-+-+ + +
| |     | |   | |   | | |   | |
+ + +-+ + + + + + +-+ + + + + +
|     | |   |       |   | |   |
+-+-+-+-+-+-+-+-+-+-+-+-+-+-+-+