+-+-+-+-+-+-+-+-+-+-+-+-+-+-+-+-+
| | |     |     | | |         | |
+ + +-+ + +-+ +-+ + + +-+ +-+-+ +
|       | |       | |   |   | | |
+ + + +-+ + + + + + + +-+-+-+ + +
| | |   | | | | |     | | |     |
+ + + + +-+-+-+-+-+-+ + + + +-+ +
| | | | | | | | | | | |   |   | |
+ + +-+-+ + + + + + + +-+ +-+ + +
| |   | | |   | | |       |   | |
+-+-+ + + +-+ + + + + +-+ + + +-+
| |       |     | | | |     | | |
+ + + +-+ + + +-+ + +-+ +-+ + + +
|   |   |   | | |   | | | | |   |
+ + + +-+-+ + + + +-+ + + +-+ + +
| | |     | |       |   |   | | |
+ +-+-+-+-+-+ +-+-+-+ +-+-+ + + +
| |     |       | | |   |     | |
+-+ +-+ + +-+-+-+ + +-+ + + + + +
|     |               | | | | | |
+-+-+-+-+-+-+-+-+-+-+-+-+-+-+-+-+