+-+-+-+-+-+-+-+-+-+-+
|   |   | |   | |   |
+-+ +-+ + +-+ + +-+ +
|   |   | |   |   | |
+ + + + + + + + +-+ +
| | | |   | |   | | |
+-+ + + + + + +-+ + +
| | | | | | | | |   |
+ + +-+-+ + + + + + +
|   |       | |   | |
+ + + + + + + + + +-+
| | | | | | | | |   |
+-+ + +-+-+-+-+ +-+ +
| | | | | | |   |   |
+ + + + + + + +-+ + +
| |   |       |   | |
+ + + +-+-+ +-+ +-+ +
| | |   | |   |   | |
+ + +-+-+ + + + +-+-+
|           | |     |
+-+-+-+-+-+-+-+-+-+-+